%%%%%%%%%%%%%%%%%%%%%
%   P     L         %
% % % %%%%%%%%% %%% %
%L% % %   % %     % %
% % % % % % % %%%%% %
% % %   %   % %     %
% %%%%%%%%%%%%%%% %%%
%     % %           %
% %%%%% % % %%%%% % %
%   % %   %     % % %
% %%% %%% %%%%%%%%% %
% %     %   %   % %.>
% % %%%%%%% % %%% % %
%         %   %   % %
% % %%%%% %%% % %%% %
% % % % %           %
%%%%% % %%%%% %%% %%%
% % %       %   % % %
% % % % %%%%% % %%% %
%     %       %     %
%%%%%%%%%%%%%%%%%%%%%